000000000000000000000000000000000000000000000000
0                                              0
0                                              0
0                                              0
0                      eweeee                  0
0                                              0
0                                     ef       0
0          5555                                0
0          5555                                0
0                                              0
0                                              0
0                                              0
0                                              0
0                                              0
0                              99999999        0
0                              99999999        0
0                                              0
0                                              0
0                                              0
0                                              0
0                                              0
0                     5555                     0
0                     5555                     0
0                                              0
0                                              0
0                                              0
0                                              0
0                                              0
0                                              0
0                                              0
0                                              0
000000000000000000000000000000000000000000000000